{
	"name": "Map1",
	"uid": "123456",
	"tile_width": 40,
	"tile_height": 40,
	"width": 100,
	"height": 100,
	"blocks": [	1,1,1,1,1,1,1,1,
				0,0,0,1,1,1,1,1,
				1,1,0,0,0,1,1,1,
				1,1,0,0,0,1,1,1,
				1,1,0,0,0,1,1,1,
				1,1,0,0,0,0,1,1,
				1,1,0,0,0,1,1,1,
				1,1,0,0,0,1,1,1
	]
	
}
