{
	"name": "Map1",
	"uid": "123456",
	"id": 1,
	"tile_width": 1,
	"tile_height": 1,
	"width": 100,
	"height": 100,
	"blocks": [ [1,1,1,1,1,1,1,1],
				[0,0,0,1,1,1,1,1],
				[1,1,0,0,0,1,1,1],
				[1,1,0,0,0,1,1,1],
				[1,1,0,0,0,1,1,1],
				[1,1,0,0,0,0,1,1],
				[1,1,0,0,0,1,1,1],
				[1,1,0,0,0,1,1,1]]
}
